1 0 1 0 0 0 1 0 1 1 1 1 1 4 1 1 1 1 0 1 0 1 1 1 1 1 1 1
0 2 1 0 0 0 1 3 2 2 2 2 2 2 2 2 2 2 2 1 2 2 2 2 2 2 2 0
1 1 1 1 1 1 1 2 1 1 1 1 1 1 1 1 1 1 1 1 1 1 1 1 1 1 1 1
0 2 1 2 2 2 2 2 1 2 2 2 2 2 2 2 2 2 2 2 3 2 2 2 2 2 2 0
1 2 4 2 1 1 1 2 1 2 1 1 1 1 2 1 1 1 1 2 1 2 1 1 1 1 4 1
1 2 1 2 2 2 2 2 1 2 1 1 1 1 2 1 1 1 1 2 1 2 1 0 4 0 5 1
1 2 1 1 1 1 1 2 1 2 2 2 2 2 2 2 2 2 2 2 2 2 1 0 1 0 6 1
1 2 2 2 3 2 1 2 1 1 1 1 1 1 2 1 1 1 1 1 1 1 1 0 1 0 7 1
1 2 1 2 1 2 1 2 1 1 2 2 2 2 2 1 2 2 2 2 2 2 2 0 4 0 8 1
1 2 1 2 1 2 4 2 1 2 2 1 1 1 1 1 2 1 1 1 1 2 1 1 1 1 1 1
0 2 1 2 1 2 1 2 2 2 1 1 2 2 2 3 2 2 2 2 1 2 1 2 2 2 2 0
1 1 1 2 2 2 1 2 1 2 2 2 2 1 1 1 1 1 1 2 1 2 1 2 1 1 1 1
0 2 1 1 1 1 1 2 1 1 1 2 1 1 2 2 2 2 1 2 2 2 1 2 2 2 2 0
1 2 1 2 3 2 1 2 2 2 1 3 3 3 3 1 1 2 1 1 1 1 1 1 1 1 1 1
0 2 1 2 1 2 1 1 1 2 1 1 1 1 2 1 1 2 2 2 1 2 9 2 2 2 2 0
1 1 1 2 1 2 2 2 1 2 2 2 2 2 2 1 1 1 1 2 1 2 1 1 1 1 1 1
0 2 1 2 1 1 1 2 1 1 1 1 1 2 1 1 1 1 1 2 1 2 2 2 2 2 2 0
1 2 2 2 2 2 2 2 1 0 0 0 1 2 2 2 2 2 1 2 1 1 1 1 1 1 1 1
1 1 1 2 1 1 1 1 1 1 1 0 1 2 1 1 1 2 2 2 1 0 0 1 2 2 2 1
0 2 2 2 2 2 2 2 2 2 1 0 1 2 2 2 2 1 1 1 1 1 1 1 2 1 2 0
1 1 1 1 1 1 1 1 1 2 1 1 1 1 1 1 2 1 2 2 2 2 2 2 2 1 1 1
0 2 2 2 2 2 2 2 1 2 2 2 2 2 2 1 2 1 3 1 1 1 1 1 2 1 2 0
1 1 1 1 1 1 1 2 6 6 6 6 6 6 2 1 2 1 2 2 2 2 2 2 2 1 2 1
0 2 2 2 2 2 1 2 1 2 2 2 2 2 2 1 2 1 2 1 1 1 1 1 2 1 2 0
1 1 1 1 1 3 1 2 2 2 1 2 1 2 1 1 2 1 2 1 2 2 2 1 2 1 1 1
0 2 2 2 2 2 1 2 1 2 1 2 1 2 1 1 2 1 2 1 2 1 2 1 2 1 2 0
1 1 1 1 1 1 1 2 1 2 1 2 1 2 1 1 2 1 2 1 2 1 2 1 2 1 2 1
1 2 2 2 2 2 2 2 1 2 2 2 1 2 2 2 2 1 2 1 2 1 2 2 2 2 2 1
1 0 1 1 1 1 1 0 1 1 1 1 1 4 1 1 1 1 0 1 0 1 1 1 1 1 1 1
4
